Here is a database schema:
continents
* ContId (number): cont id
* Continent (text): continent

countries
* CountryId (number): country id
* CountryName (text): country name
* Continent (number): continent

car_makers
* Id (number): id
* Maker (text): maker
* FullName (text): full name
* Country (text): country

model_list
* ModelId (number): model id
* Maker (number): maker
* Model (text): model

car_names
* MakeId (number): make id
* Model (text): model
* Make (text): make

cars_data
* Id (number): id
* MPG (text): mpg
* Cylinders (number): cylinders
* Edispl (number): edispl
* Horsepower (text): horsepower
* Weight (number): weight
* Accelerate (number): accelerate
* Year (number): year
Please write me a SQL statement that answers the following question:
In 1980, how many cars were made?
Remember, DO NOT provide any commentary or explanation of what the code does, just the SQL statement ending in a semicolon.